18 18 18 18 18 18 18 18 18 18 18 18 18 18 18 18 18 18 18 18 18 18 18 18 18 18 18 18 18 18 18 18 18 18 18 18 18 18 18 18 18 18 18 18 18 18 18 18 18 18 18 18 18 18 18 18 18 18 18 18 18 18 18 18 18 18 18 18 18 18 18 18 18 18 18 18 18 18 18 18 18 18 18 18 18 18 18 18 18 18 18 18 18 18 18 18 18 18 18 18 
18 18 18 18 19 18 18 18 18 18 18 18 18 18 18 18 18 18 18 18 18 18 18 18 18 18 18 18 18 18 18 18 18 18 18 18 18 18 18 18 18 18 18 18 18 18 18 18 18 18 18 18 18 18 18 18 18 18 18 18 18 18 18 18 18 18 18 18 18 18 18 18 18 18 18 18 18 18 18 18 18 18 18 18 18 18 18 18 18 18 18 18 18 18 18 18 18 18 18 18 
18 18 18 18 18 18 18 18 18 18 18 18 18 18 18 18 18 18 18 18 18 18 18 18 18 18 18 18 18 18 18 18 18 18 18 18 18 18 18 18 18 18 18 18 18 18 18 18 18 18 18 18 18 18 18 18 18 18 18 18 18 18 18 18 18 18 18 18 18 18 18 18 18 18 18 18 18 18 18 18 18 18 18 18 18 18 18 18 18 18 18 18 18 18 18 18 18 18 18 18 
18 18 18 19 18 18 18 18 18 18 18 18 18 18 18 18 18 18 18 18 18 18 18 18 18 18 18 18 18 18 18 18 18 18 18 18 18 18 18 18 18 18 18 18 18 18 18 18 18 18 18 18 18 18 18 18 18 18 18 18 18 18 18 18 18 18 18 18 18 18 18 18 18 18 18 18 18 18 18 18 18 18 18 18 18 18 18 18 18 18 18 18 18 18 18 18 18 18 18 18 
18 18 18 18 18 18 18 19 18 18 18 18 18 18 18 18 18 18 18 18 18 18 18 18 18 18 18 18 18 18 18 18 18 18 18 18 18 18 18 18 18 18 18 18 18 18 18 18 18 18 18 18 18 18 18 18 18 18 18 18 18 18 18 18 18 18 18 18 18 18 18 18 18 18 18 18 18 18 18 18 18 18 18 18 18 18 18 18 18 18 18 18 18 18 18 18 18 18 18 18 
18 18 19 18 18 18 18 18 18 18 18 18 18 18 18 18 18 18 18 18 18 18 18 18 18 18 18 18 18 18 18 18 18 18 18 18 18 18 18 18 18 18 18 18 18 18 18 18 18 18 18 18 18 18 18 18 18 18 18 18 18 18 18 18 18 18 18 18 18 18 18 18 18 18 18 18 18 18 18 18 18 18 18 18 18 18 18 18 18 18 18 18 18 18 18 18 18 18 18 18 
18 18 18 18 18 18 18 18 18 18 18 18 18 18 18 18 18 18 18 18 18 18 18 18 18 18 18 18 18 18 18 18 18 18 18 18 18 18 18 18 18 18 18 18 18 18 18 18 18 18 18 18 18 18 18 18 18 18 18 18 18 18 18 18 18 18 18 18 18 18 18 18 18 18 18 18 18 18 18 18 18 18 18 18 18 18 18 18 18 18 18 18 18 18 18 18 18 18 18 18 
18 19 19 18 18 18 18 18 19 18 18 18 18 18 18 18 18 18 18 18 18 18 18 18 18 18 18 18 18 18 18 18 18 18 18 18 18 18 18 18 18 18 18 18 18 18 18 18 18 18 18 18 18 18 18 18 18 18 18 18 18 18 18 18 18 18 18 18 18 18 18 18 18 18 18 18 18 18 18 18 18 18 18 18 18 18 18 18 18 18 18 18 18 18 18 18 18 18 18 18 
18 18 18 18 18 18 18 18 18 18 18 18 18 18 18 18 18 18 18 18 18 18 18 18 18 18 18 18 18 18 18 18 18 18 18 18 18 18 18 18 18 18 18 18 18 18 18 18 18 18 18 18 18 18 18 18 18 18 18 18 18 18 18 18 18 18 18 18 18 18 18 18 18 18 18 18 18 18 18 18 18 18 18 18 18 18 18 18 18 18 18 18 18 18 18 18 18 18 18 18 
18 18 19 18 18 18 18 18 18 18 18 18 18 18 18 18 18 18 18 18 18 18 18 18 18 18 18 18 18 18 18 18 18 18 18 18 18 18 18 18 18 18 18 18 18 18 18 18 18 18 18 18 18 18 18 18 18 18 18 18 18 18 18 18 18 18 18 18 18 18 18 18 18 18 18 18 18 18 18 18 18 18 18 18 18 18 18 18 18 18 18 18 18 18 18 18 18 18 18 18 
19 18 19 19 18 19 19 19 19 18 18 18 18 18 18 18 18 18 18 18 18 18 18 18 18 18 18 18 18 18 18 18 18 18 18 18 18 18 18 18 18 18 18 18 18 18 18 18 18 18 18 18 18 18 18 18 18 18 18 18 18 18 18 18 18 18 18 18 18 18 18 18 18 18 18 18 18 18 18 18 18 18 18 18 18 18 18 18 18 18 18 18 18 18 18 18 18 18 18 18 
18 19 19 19 18 18 18 19 18 18 19 19 18 19 18 18 18 18 18 18 18 18 18 18 18 18 18 18 18 18 18 18 18 18 18 18 18 18 18 18 18 18 18 19 19 18 18 18 18 19 19 18 18 18 18 18 18 18 18 18 18 18 18 18 18 18 18 18 18 18 18 18 18 18 18 18 18 18 18 18 18 18 18 18 18 18 18 18 18 18 18 18 18 18 18 18 18 18 18 18 
18 18 18 18 18 18 18 18 18 19 18 19 18 19 18 18 18 18 18 18 18 18 18 18 18 18 18 18 18 18 18 18 18 18 18 18 18 18 18 18 18 18 19 19 19 19 19 18 19 19 19 18 18 19 19 19 19 18 18 18 18 18 18 18 18 18 18 18 18 18 18 18 18 18 18 19 18 18 18 18 18 18 18 18 18 18 18 18 18 18 18 18 18 18 18 18 18 18 18 18 
18 18 18 18 19 19 18 18 19 19 18 18 19 19 18 18 18 18 18 18 18 18 18 18 18 18 18 18 18 18 18 18 18 18 18 18 18 18 18 18 18 19 18 18 18 18 19 19 19 18 19 18 19 19 18 18 19 19 18 18 18 18 18 18 19 19 19 19 19 19 19 18 18 18 18 18 18 18 18 18 18 18 18 18 18 18 18 18 18 18 18 18 18 18 18 18 18 18 18 18 
18 18 18 18 18 18 18 18 18 18 19 18 19 18 18 18 18 18 18 18 18 18 18 18 18 18 18 18 18 18 18 18 18 18 18 18 18 18 18 18 18 19 18 18 18 18 19 19 18 18 19 18 19 18 18 18 18 18 19 18 18 18 19 19 19 18 19 19 19 19 19 19 19 18 18 18 18 18 18 18 18 18 18 18 18 18 18 18 18 18 18 18 18 18 18 18 18 18 18 18 
18 18 18 19 18 18 18 18 18 18 19 18 18 19 18 18 18 18 18 18 18 18 18 18 18 18 18 18 18 18 18 18 18 18 18 19 19 18 18 18 19 19 19 19 19 19 19 18 18 18 19 18 19 19 18 18 18 18 19 19 19 19 19 18 19 18 19 19 19 18 18 18 18 18 18 18 18 19 19 18 18 18 18 18 18 18 18 18 18 18 18 18 18 18 18 18 18 18 18 18 
18 18 18 19 19 19 19 19 19 18 18 18 18 19 18 18 18 18 18 18 18 18 18 18 18 18 18 18 18 18 18 18 18 18 18 19 19 18 18 18 19 19 19 19 19 19 18 18 18 19 19 18 19 19 19 18 18 18 18 18 18 18 19 19 18 18 19 19 19 18 19 18 18 19 19 19 19 19 18 18 18 18 18 18 18 18 18 18 18 18 18 18 18 18 18 18 18 18 18 18 
18 18 18 18 18 18 18 18 18 18 18 18 18 18 18 18 18 18 18 18 18 18 18 18 18 18 18 18 18 18 18 18 18 19 19 19 19 19 19 19 18 18 18 19 18 19 19 19 19 19 19 19 19 18 19 19 18 18 18 18 18 19 18 18 18 18 19 19 19 19 19 19 19 19 19 19 19 19 18 18 18 18 18 18 18 18 18 18 18 18 18 18 18 18 18 18 18 18 18 18 
18 18 18 18 18 18 18 18 18 18 19 19 19 19 19 18 18 18 18 18 18 18 18 18 18 18 18 19 19 18 18 18 18 18 18 18 19 19 18 18 18 18 18 18 19 19 18 18 18 19 19 18 18 18 28 26 26 26 26 26 26 26 29 19 19 19 18 18 18 18 18 18 18 18 19 19 18 18 18 18 18 18 18 18 18 18 18 18 18 18 18 18 18 18 18 18 18 18 18 18 
18 18 19 18 18 18 18 19 19 19 18 18 18 18 19 19 19 18 18 18 18 18 18 18 18 19 19 18 19 18 18 18 18 18 18 18 19 19 19 18 18 18 18 18 18 19 19 19 19 19 18 18 18 18 24 16 16 16 16 16 16 16 23 19 18 18 18 18 18 18 18 18 18 18 18 18 18 18 18 18 18 18 18 18 18 18 18 18 18 18 18 18 18 18 18 18 18 18 18 18 
18 19 19 18 18 18 19 18 18 19 19 18 18 18 18 18 18 18 18 18 18 18 18 18 18 19 19 19 19 19 19 19 19 18 18 18 18 19 19 19 19 19 19 19 18 18 18 18 18 18 18 18 18 18 24 16 2 2 2 2 2 16 23 18 18 18 18 19 19 19 19 19 19 19 18 18 18 18 18 18 18 18 18 18 18 18 18 18 18 18 18 18 18 18 18 18 18 18 18 18 
18 19 19 19 18 19 19 18 18 18 18 19 18 18 18 18 18 18 18 18 18 18 19 19 19 19 18 18 18 18 18 18 18 18 18 18 18 18 19 19 18 18 18 18 18 18 18 18 18 18 18 18 18 18 24 16 12 10 10 10 13 16 23 18 19 19 19 18 18 18 19 19 19 18 18 19 19 19 19 19 18 19 19 19 19 19 19 19 19 19 19 19 19 18 18 18 18 18 18 18 
18 19 18 19 19 19 19 18 18 18 19 19 18 18 18 18 18 18 18 18 18 19 19 18 19 18 18 18 18 18 18 18 18 18 18 18 18 18 18 18 18 19 18 18 18 18 18 18 19 19 18 18 18 18 24 16 8 3 3 3 7 16 23 19 19 19 19 19 19 19 19 18 19 18 19 19 18 19 18 18 19 19 19 18 18 18 19 19 19 19 19 19 18 18 18 18 18 18 18 18 
18 19 18 18 18 18 18 18 19 19 19 18 18 18 18 18 18 18 18 19 19 18 18 18 19 19 18 18 18 18 18 18 18 18 18 18 18 18 18 18 18 19 19 18 18 18 18 19 18 19 19 18 18 18 24 16 8 3 4 5 15 16 23 19 19 18 18 19 19 19 19 19 19 18 19 19 19 19 19 19 18 19 18 19 19 19 18 19 18 18 19 19 18 18 18 18 18 18 18 18 
18 19 19 18 18 18 18 18 19 19 19 18 18 18 18 18 18 18 18 18 18 19 18 19 18 18 18 18 18 18 18 18 18 19 19 19 18 18 19 19 19 19 19 19 19 18 19 19 19 18 19 18 18 18 24 16 8 3 7 2 2 16 23 18 19 19 19 18 18 18 18 18 18 18 18 18 18 18 19 18 19 19 19 18 19 19 18 19 18 18 19 19 19 19 19 19 19 19 18 18 
18 18 19 19 19 19 19 19 18 18 19 19 19 18 18 19 19 19 18 18 19 18 18 19 19 18 18 19 19 18 18 19 19 19 18 18 18 18 18 18 19 18 18 19 19 19 19 18 18 18 19 18 18 18 24 16 8 3 7 2 2 16 25 26 26 26 26 26 26 26 26 26 26 26 26 26 29 18 19 19 19 19 19 19 19 18 19 19 19 19 19 19 19 19 18 19 19 19 19 18 
18 18 18 18 18 18 18 18 18 18 18 18 18 18 18 18 18 18 18 18 18 18 18 18 18 18 18 18 18 18 18 18 19 19 19 19 18 18 18 18 19 19 19 19 19 19 18 18 18 19 19 18 18 18 24 16 8 3 7 2 2 16 16 16 16 16 16 16 16 16 16 16 16 16 16 16 23 18 19 19 18 18 18 19 18 18 19 18 19 19 19 19 19 19 19 18 18 18 19 18 
18 18 18 18 18 18 18 18 18 18 18 18 18 19 19 18 18 18 18 18 18 18 18 18 18 18 18 18 18 18 18 18 19 18 18 18 19 19 19 19 18 18 19 19 19 19 19 19 19 19 18 18 18 18 24 16 8 3 7 2 2 2 2 2 2 2 2 2 2 2 2 2 2 2 2 16 23 18 18 19 18 18 18 19 18 18 19 18 18 19 19 19 18 18 19 18 18 18 19 18 
18 18 19 19 18 18 18 19 19 19 19 18 18 18 19 19 18 18 18 18 18 18 18 18 18 18 18 18 18 18 18 18 19 19 19 19 18 18 18 19 19 18 18 18 18 18 18 18 18 18 18 18 18 18 24 16 8 3 9 10 13 2 2 2 2 2 12 10 13 2 2 12 13 2 2 16 25 26 26 26 26 26 26 29 18 18 19 19 19 18 18 18 18 18 19 18 18 19 18 19 
18 18 19 18 18 19 19 18 18 19 19 19 19 18 18 18 18 18 18 18 18 18 18 18 18 18 18 18 18 18 18 18 19 19 18 19 19 19 18 18 19 19 18 18 18 18 18 18 18 18 18 18 18 18 24 16 8 3 3 3 9 10 10 10 10 10 11 3 7 2 2 14 15 2 2 16 16 16 16 16 16 16 16 23 18 18 18 19 19 19 19 19 19 19 18 18 18 19 19 19 
18 18 19 18 19 19 18 19 19 19 19 18 19 18 18 18 18 18 18 18 18 18 18 18 18 18 18 18 18 18 18 19 19 19 18 18 18 18 18 19 19 19 18 18 18 18 18 18 18 18 18 18 18 18 24 16 14 5 6 3 3 3 3 3 3 3 3 3 7 2 2 2 2 2 2 2 2 2 2 2 2 2 16 23 19 19 18 18 18 18 18 18 18 18 18 19 19 19 18 18 
18 18 19 19 19 18 19 19 18 18 19 19 19 18 18 18 18 19 19 18 18 18 18 18 18 18 18 18 18 18 18 19 18 19 19 19 19 19 19 19 18 18 18 18 18 18 18 18 18 18 18 18 18 18 24 16 2 2 14 5 5 5 5 5 5 5 6 3 9 10 10 13 12 10 10 10 10 10 10 10 10 13 16 23 18 19 19 19 19 19 19 19 19 18 19 19 19 18 18 18 
18 18 18 18 19 19 19 19 19 19 19 19 18 18 18 19 19 19 18 18 18 18 18 19 19 19 18 18 18 18 18 18 19 18 18 18 18 18 18 18 18 18 18 18 18 18 18 18 18 18 18 18 18 18 24 16 2 2 2 2 16 16 16 2 2 2 8 3 3 3 3 9 11 3 3 3 3 3 3 3 3 7 16 23 18 18 18 19 19 19 18 18 18 19 18 18 18 18 18 18 
18 18 19 19 19 18 19 19 18 18 19 18 18 18 19 19 19 19 18 18 18 19 19 18 18 19 19 18 18 18 18 18 19 19 19 19 19 18 18 18 18 18 18 18 18 18 18 18 18 18 18 18 18 18 24 16 16 16 16 16 16 2 2 2 2 2 8 3 4 6 3 3 3 4 5 5 5 5 5 6 3 7 16 23 18 18 19 19 18 19 18 18 18 19 18 18 18 18 18 18 
18 18 18 18 18 18 19 19 19 19 18 18 18 18 19 18 19 19 18 19 19 18 18 18 18 18 19 19 18 18 18 18 18 18 18 18 18 19 19 19 18 18 18 18 18 18 18 18 18 18 18 18 18 18 24 16 2 2 2 2 2 16 2 2 12 10 11 3 7 14 5 5 5 15 2 2 2 2 12 11 3 7 16 23 18 18 19 18 18 19 18 18 18 19 18 18 18 18 18 18 
18 18 18 18 18 18 18 18 18 18 18 18 18 19 18 18 18 19 19 19 18 18 18 18 18 18 19 19 18 18 18 18 18 18 18 18 18 18 18 18 18 18 18 18 18 18 18 18 18 18 18 18 18 18 24 16 2 12 10 10 10 10 10 10 11 3 3 3 7 2 2 2 2 2 2 12 10 10 11 3 4 15 16 23 18 19 19 18 18 19 18 18 19 19 18 18 18 18 18 18 
18 18 18 18 18 18 18 18 18 18 18 18 18 18 18 18 19 18 19 19 18 18 19 19 19 19 19 18 18 18 18 18 18 18 18 18 18 18 18 18 18 18 18 18 18 18 18 18 18 18 18 18 18 18 24 16 2 8 3 3 3 3 3 3 3 4 6 3 7 2 2 2 2 2 2 8 3 3 3 4 15 2 16 23 18 19 19 19 19 19 19 19 19 19 18 18 18 18 18 18 
18 18 19 18 18 18 18 18 18 18 18 19 18 18 18 19 19 19 19 19 18 18 19 18 18 18 18 18 28 26 26 26 26 26 26 26 26 26 26 26 26 26 26 26 26 26 26 26 26 26 26 26 26 26 27 16 2 8 3 4 5 5 5 5 5 15 8 3 7 2 2 2 2 16 16 14 5 5 5 15 16 16 16 23 18 19 19 18 19 19 19 19 19 19 18 18 18 18 18 18 
18 18 19 18 18 18 18 18 19 19 19 19 18 18 19 19 19 19 19 19 19 19 19 19 18 18 18 18 24 16 16 16 16 16 16 16 16 16 16 16 16 16 16 16 16 16 16 16 16 16 16 16 16 16 16 16 2 8 3 7 2 2 2 2 2 2 8 3 7 2 2 2 2 16 20 21 21 21 21 21 21 21 21 31 19 19 19 19 19 19 18 19 19 19 18 18 18 18 18 18 
18 18 19 18 18 18 19 19 18 19 19 19 18 18 19 18 18 18 19 19 19 18 18 18 18 18 18 18 24 16 2 2 2 2 2 2 2 2 2 2 2 2 2 2 2 2 2 2 2 2 2 2 2 2 2 2 2 8 3 7 2 2 2 2 2 2 8 3 7 2 2 2 2 16 23 18 18 18 18 18 18 18 18 18 18 19 18 18 19 19 19 19 19 19 18 18 18 18 18 18 
18 18 19 19 19 19 19 18 19 19 18 19 18 18 18 18 18 18 18 18 18 18 18 18 18 18 18 18 24 16 2 2 2 2 2 2 2 2 2 2 12 10 13 2 2 2 2 2 2 2 2 2 2 2 2 2 2 8 3 7 2 2 2 2 2 2 8 3 7 2 2 2 2 16 23 18 18 19 19 19 18 18 18 18 19 19 19 18 19 18 18 18 18 18 18 18 18 18 18 18 
19 19 19 19 19 19 18 19 19 19 19 19 18 18 18 18 18 18 18 18 18 18 18 18 18 18 18 18 24 16 2 2 2 2 2 2 2 2 2 2 8 3 7 2 2 2 2 2 2 2 2 2 2 2 2 2 2 8 3 7 2 2 2 2 2 2 8 3 7 2 2 2 2 16 23 18 19 19 18 19 18 18 19 18 19 18 19 18 19 18 18 18 18 18 18 18 18 18 18 18 
19 18 18 18 18 19 19 19 18 18 18 18 18 18 19 19 18 18 18 19 18 18 18 18 18 19 18 18 24 16 2 2 2 2 2 2 2 2 2 2 8 3 7 2 2 2 2 2 2 2 2 2 2 2 2 2 2 8 3 7 2 2 2 2 2 2 8 3 9 10 10 13 2 16 23 19 19 18 18 19 18 18 19 19 18 18 19 18 19 18 18 18 18 18 18 18 18 18 18 18 
19 19 19 19 19 19 19 18 19 19 19 19 18 18 19 19 18 18 19 19 19 19 19 18 18 19 18 18 24 16 2 2 2 2 2 2 2 12 10 10 11 3 9 13 2 2 2 2 2 2 2 2 2 2 2 2 2 8 3 7 2 2 2 2 2 2 8 3 3 3 3 7 2 16 23 18 18 18 18 19 19 19 19 19 19 19 19 19 18 18 18 18 18 18 18 18 18 18 18 18 
18 18 18 18 18 19 18 19 19 19 19 18 18 19 18 19 19 18 19 19 19 18 19 19 18 19 18 18 24 16 2 2 2 2 2 12 10 11 3 3 3 3 3 9 13 2 2 2 2 2 2 2 2 2 2 2 2 14 5 15 2 2 2 2 2 2 8 3 4 5 5 15 2 16 23 18 19 18 18 19 19 19 19 19 19 19 19 18 18 19 19 18 18 18 18 18 18 18 18 18 
18 18 18 18 18 18 19 19 19 19 19 18 18 19 18 18 19 19 19 19 18 18 18 19 19 19 18 18 24 16 2 2 2 12 10 11 3 3 3 4 5 6 3 3 9 10 10 10 13 2 2 2 2 2 2 2 2 2 2 2 2 2 2 2 2 2 8 3 7 2 2 2 2 16 23 19 19 19 18 19 19 19 18 18 18 18 18 18 19 19 19 19 18 18 18 18 18 18 18 18 
18 18 19 19 18 19 19 18 18 18 19 18 18 19 18 18 19 19 18 18 19 18 18 19 19 19 18 18 24 16 2 12 10 11 3 3 3 4 5 15 2 14 6 3 3 3 3 3 9 10 10 10 10 10 10 10 10 10 10 10 10 10 10 10 10 10 11 3 7 2 2 2 2 16 23 19 18 18 19 19 19 19 19 18 19 18 18 19 19 18 18 19 19 19 19 18 18 18 18 18 
18 19 19 19 19 19 18 18 18 18 18 19 18 19 18 19 19 19 19 18 19 18 18 18 18 19 18 18 24 16 2 8 3 3 3 4 5 15 16 2 2 2 14 5 5 5 6 3 3 3 3 3 3 3 3 3 3 3 3 3 3 3 3 3 3 3 3 3 7 2 2 2 2 16 23 19 18 18 19 18 19 18 19 18 18 19 19 19 18 18 18 18 18 18 18 18 18 18 18 18 
18 18 18 18 18 19 18 18 18 18 18 19 18 19 19 19 18 18 18 19 19 19 19 18 19 19 18 18 24 16 2 14 6 3 4 15 2 2 16 16 2 2 16 16 2 2 14 5 5 5 5 5 5 6 3 4 5 5 5 5 5 5 5 5 5 5 6 3 7 2 2 2 2 16 23 19 18 19 19 18 19 18 19 19 19 18 18 19 18 18 18 18 18 18 19 18 18 18 18 18 
18 18 18 18 18 19 19 19 19 18 18 19 18 18 19 19 19 18 18 18 18 19 19 19 19 18 18 18 24 16 2 12 11 3 7 2 16 2 2 2 16 16 16 2 2 2 2 16 16 2 2 2 2 8 3 7 2 2 2 2 2 2 2 2 2 2 8 3 7 2 2 2 2 16 23 19 18 18 18 19 18 18 18 18 18 19 19 19 19 19 19 19 19 19 19 18 18 18 18 18 
18 18 18 18 19 19 18 18 18 19 19 19 19 19 19 18 19 18 18 19 18 18 19 19 18 28 26 26 27 16 2 8 3 3 7 2 16 16 2 2 2 2 2 2 2 2 2 2 16 16 2 2 2 8 3 7 16 16 16 16 16 16 16 16 16 16 8 3 7 2 2 2 2 16 23 19 18 19 18 18 18 18 19 18 19 19 19 19 19 19 19 18 18 18 18 18 18 18 18 18 
19 18 18 18 19 19 18 19 19 19 19 18 18 18 18 18 19 19 18 19 19 19 19 19 18 24 16 16 16 16 12 11 3 4 15 2 2 16 2 2 2 16 16 16 16 2 2 2 2 16 2 2 2 8 3 7 2 16 16 16 16 2 2 2 2 2 8 3 7 2 2 2 2 16 25 26 26 26 26 26 26 26 29 18 18 19 19 18 18 19 19 19 18 18 18 18 18 18 18 18 
19 19 19 19 19 19 19 19 19 19 19 18 18 18 19 19 18 19 19 19 19 19 19 19 18 24 16 2 2 12 11 3 3 7 2 2 2 16 16 16 16 2 2 2 16 2 2 2 2 16 16 2 2 14 5 15 2 2 2 2 16 16 2 2 2 2 8 3 7 2 2 2 2 16 16 16 16 16 16 16 16 16 23 18 18 19 19 19 18 18 19 19 19 19 18 18 18 18 18 18 
18 18 18 18 18 18 18 18 18 18 18 19 18 19 19 19 18 18 18 18 18 18 18 18 18 24 16 12 10 11 3 3 4 15 2 2 2 2 16 16 2 2 2 16 16 2 2 2 2 16 16 16 2 2 2 2 2 2 2 2 2 16 16 16 2 2 8 3 7 2 2 2 2 12 10 13 2 2 2 2 2 16 23 19 19 19 19 19 19 19 19 18 18 18 18 18 18 18 18 18 
18 18 18 19 19 19 18 18 18 18 28 26 26 26 26 26 26 26 26 26 26 26 26 26 26 27 2 8 3 3 3 4 15 2 2 2 16 16 2 2 2 2 16 16 2 2 2 2 2 2 2 16 2 2 2 16 16 2 2 2 2 2 2 16 2 2 8 3 7 2 2 2 2 8 3 7 2 2 2 2 2 16 23 19 19 19 18 18 19 18 18 18 19 18 18 18 18 18 18 18 
18 18 19 19 18 19 18 18 18 18 24 2 2 2 16 16 16 16 2 2 2 2 2 12 10 10 10 11 3 4 5 15 2 2 2 16 16 2 2 2 2 16 16 2 2 2 2 2 2 2 16 16 2 2 2 2 16 2 2 2 2 2 16 16 2 2 8 3 7 2 2 2 2 8 3 9 10 10 10 13 2 16 23 18 18 19 19 19 19 18 18 18 19 18 18 18 18 18 18 18 
19 19 18 18 18 19 18 19 19 18 24 2 16 16 16 2 2 2 2 16 16 2 2 8 3 3 3 3 3 7 2 2 2 16 16 16 16 16 16 2 2 16 2 2 2 12 13 2 16 16 16 2 2 2 2 2 16 16 2 2 2 16 16 2 2 2 8 3 7 2 2 2 2 8 3 3 3 3 3 7 2 16 23 18 18 19 18 19 19 18 18 19 19 18 18 18 18 18 18 18 
19 18 18 18 18 19 18 19 19 18 24 16 16 16 33 2 2 2 16 16 16 2 2 8 3 3 4 5 5 15 2 16 16 16 16 16 16 16 16 2 2 2 2 2 2 14 15 2 16 2 2 2 2 2 2 2 2 16 16 16 16 16 2 2 2 2 8 3 9 13 2 2 2 8 3 4 5 5 5 15 2 16 23 18 18 19 18 19 19 18 19 19 19 18 18 18 18 18 18 18 
18 18 19 19 19 19 18 19 19 18 24 16 16 16 16 2 16 16 16 16 2 2 2 8 3 3 9 13 2 2 16 16 2 2 16 16 2 2 2 16 16 2 2 2 2 2 2 2 16 2 2 2 2 2 2 16 16 16 2 2 2 2 2 2 2 2 8 3 3 9 10 10 10 11 3 7 2 2 2 2 2 16 23 18 19 18 18 19 19 19 19 18 19 18 18 18 18 18 18 18 
18 18 19 19 19 19 19 19 18 18 24 16 2 16 16 16 16 16 16 16 16 16 16 8 3 3 3 9 10 13 2 2 2 2 16 2 2 2 2 2 16 16 2 2 2 2 2 2 2 16 16 16 16 16 16 16 2 2 2 2 2 2 2 2 2 2 14 6 3 3 3 3 3 3 3 7 2 2 2 2 2 16 23 18 19 18 18 19 19 19 18 19 19 18 18 18 18 18 18 18 
18 18 19 19 18 19 19 18 18 18 24 16 16 2 16 16 16 16 16 2 2 16 16 14 5 6 3 3 3 9 13 2 2 16 16 2 2 2 2 2 2 16 16 16 2 2 2 2 2 2 2 2 2 2 2 2 2 2 2 16 16 16 16 16 16 2 2 14 5 5 5 5 5 6 3 7 2 2 2 2 2 16 23 19 19 18 18 18 18 19 19 19 18 18 18 18 18 18 18 18 
18 18 18 19 19 19 18 18 18 18 24 16 16 2 2 16 16 16 16 2 2 2 16 2 2 14 5 6 3 3 7 2 16 16 2 2 2 2 2 2 2 2 2 16 16 16 2 2 2 2 2 2 2 2 2 2 2 2 2 2 2 2 16 16 16 2 2 2 16 2 2 2 16 8 3 7 2 2 2 2 2 16 23 18 18 18 18 18 18 18 19 19 18 18 18 18 18 18 18 18 
18 18 18 18 18 19 19 18 18 18 30 21 21 21 21 21 21 22 16 2 2 16 16 12 10 10 10 11 3 4 15 16 16 16 16 16 16 16 16 16 2 2 2 2 2 16 16 2 2 16 2 12 10 10 10 10 10 10 10 10 10 10 10 10 10 10 10 10 10 10 10 10 10 11 3 9 13 2 2 2 2 16 23 18 18 19 19 19 18 18 18 18 18 18 18 18 18 18 18 18 
18 18 18 18 18 18 18 18 19 19 19 19 18 18 18 18 18 24 16 2 2 2 12 11 3 3 3 3 4 15 16 16 16 16 16 16 16 16 16 16 2 2 2 2 2 2 2 2 2 2 2 8 3 3 3 3 3 3 3 3 3 3 3 3 3 3 3 3 3 3 3 3 3 3 3 3 7 2 2 2 2 16 23 18 19 19 18 19 19 18 18 19 19 19 18 18 18 18 18 18 
18 18 18 18 18 18 18 19 19 18 18 19 19 19 18 18 18 24 16 2 2 12 11 3 3 4 5 5 15 2 16 16 16 3 3 9 11 3 3 16 2 2 2 2 2 16 16 16 2 2 2 8 3 4 5 5 5 5 5 5 5 5 5 5 5 6 3 4 5 5 5 5 5 5 5 5 15 2 2 2 2 16 23 18 19 19 19 19 19 19 18 19 18 19 18 18 18 18 18 18 
18 18 19 19 19 19 19 19 19 19 19 18 18 19 19 18 18 24 16 2 12 11 3 3 4 15 2 2 2 16 16 33 33 3 3 35 35 3 3 7 2 2 16 16 16 16 2 16 16 16 2 8 3 7 2 2 2 2 2 2 2 2 16 16 2 8 3 7 2 2 2 2 2 2 2 2 2 2 2 2 2 16 23 18 19 19 19 18 19 19 19 18 18 19 18 18 18 18 18 18 
18 18 19 19 18 18 19 18 18 18 19 19 19 18 19 18 18 24 16 2 8 3 3 4 15 2 2 16 16 16 33 33 3 3 3 3 3 3 3 7 2 2 2 2 2 2 2 2 2 16 2 8 3 7 2 2 16 16 16 16 16 16 16 16 2 8 3 7 2 2 2 2 2 2 2 2 2 2 2 2 2 16 23 18 18 19 19 18 19 19 19 18 19 19 18 18 18 18 18 18 
18 18 19 19 19 19 19 18 18 18 18 18 19 18 18 19 18 24 16 2 8 3 4 15 16 16 16 16 16 16 16 16 16 16 16 16 16 16 16 16 16 2 2 2 2 2 2 2 2 16 2 8 3 7 2 16 16 2 2 2 2 2 2 2 2 8 3 7 2 2 2 2 2 2 2 2 2 2 2 16 16 16 23 18 18 18 19 19 19 19 19 19 19 19 18 18 18 18 18 18 
18 18 18 19 19 19 19 18 18 18 18 18 19 18 18 19 18 24 16 2 14 5 15 2 16 20 21 21 21 21 21 21 21 21 21 21 21 21 21 22 16 2 2 16 16 16 16 16 16 16 2 8 3 7 2 16 2 2 2 2 2 2 2 2 2 14 5 15 16 16 16 16 16 16 16 16 16 16 16 16 16 16 23 18 18 19 19 19 19 19 18 18 18 19 18 18 18 18 18 18 
18 18 18 18 18 18 18 19 19 18 18 19 19 18 18 18 18 24 16 16 2 2 2 2 16 23 18 18 19 19 18 18 19 19 19 18 19 19 19 24 16 2 2 16 2 2 16 16 2 2 2 8 3 7 2 16 20 21 21 21 21 21 21 21 21 21 21 21 21 21 21 21 21 21 21 21 21 21 21 21 21 21 31 19 19 19 18 18 18 19 19 18 18 19 18 18 18 18 18 18 
18 18 18 18 18 18 18 18 18 19 19 19 18 18 18 18 18 30 22 16 2 2 2 2 16 23 18 19 19 19 19 19 19 18 19 19 19 18 19 24 16 2 2 2 2 2 2 2 2 2 2 8 3 7 2 16 23 19 18 18 18 18 18 18 18 18 18 19 19 19 18 18 18 18 18 18 18 18 18 18 18 18 18 19 18 18 18 18 18 18 19 19 18 19 18 18 18 18 18 18 
18 18 18 18 18 18 18 18 19 19 19 19 19 19 19 18 18 18 24 16 16 2 2 16 16 23 18 19 19 19 19 18 18 19 19 19 18 19 19 24 12 10 10 10 10 10 10 10 10 10 10 11 3 7 2 16 23 18 18 19 18 18 19 19 19 19 18 19 19 19 19 19 19 19 18 18 18 18 18 18 19 19 19 18 18 18 18 18 18 18 18 18 18 18 18 18 18 18 18 18 
18 18 18 18 18 18 18 18 19 18 18 18 18 18 19 18 18 18 24 16 16 16 2 2 16 23 18 19 19 19 18 18 18 18 19 19 18 19 18 24 8 3 3 3 3 3 3 3 3 3 3 3 3 7 2 16 23 19 18 18 18 18 18 18 18 19 19 19 18 18 19 18 18 18 18 18 19 18 19 19 19 18 19 19 19 19 18 18 18 18 18 18 18 18 18 18 18 18 18 18 
18 18 18 18 18 18 18 18 18 18 18 18 18 18 19 18 18 18 24 16 2 16 2 2 16 23 19 18 18 19 19 19 19 19 19 19 18 19 18 24 14 5 5 5 5 5 5 5 5 5 5 6 3 7 2 16 23 19 18 28 26 26 29 18 19 19 19 18 18 18 18 18 18 18 19 18 19 19 19 19 19 19 19 19 18 19 19 18 18 18 18 18 18 18 18 18 18 18 18 18 
19 19 18 18 18 19 19 19 19 18 19 19 18 18 19 19 18 18 24 16 2 16 2 2 16 23 18 18 18 18 18 18 18 18 18 19 18 18 18 24 16 16 16 16 16 16 16 16 16 16 2 8 3 7 2 16 23 19 18 24 33 33 23 19 18 18 18 19 18 19 18 18 19 18 18 18 18 18 19 19 19 18 19 19 18 18 19 18 18 18 18 18 18 18 18 18 18 18 18 18 
18 19 19 19 19 18 19 19 19 19 19 19 19 19 19 19 18 18 24 16 16 16 16 2 16 25 26 26 26 26 29 18 19 19 18 19 18 18 18 30 21 21 21 21 21 21 21 21 22 16 2 8 3 7 2 16 23 18 19 24 2 2 25 26 26 26 29 18 28 26 26 26 26 26 26 26 26 29 19 19 18 18 19 18 18 19 19 18 18 18 18 18 18 18 18 18 18 18 18 18 
18 18 19 19 18 19 18 18 18 18 18 19 19 19 19 19 18 18 30 21 21 22 16 2 16 16 16 16 16 16 23 19 18 19 19 18 18 18 18 18 18 18 18 18 18 18 18 18 24 16 2 8 3 7 2 16 25 26 26 27 2 2 16 16 16 16 23 18 24 33 2 2 2 2 2 2 2 23 18 19 18 19 19 18 19 19 18 18 18 18 18 18 18 18 18 18 18 18 18 18 
18 19 19 19 19 19 18 18 18 19 19 18 19 19 19 18 19 18 18 18 18 24 16 2 2 2 2 2 2 16 23 19 18 18 19 18 18 18 19 19 19 18 18 18 18 18 18 18 24 16 2 8 3 7 2 16 16 16 16 16 2 2 2 2 16 16 23 19 24 16 2 2 2 35 2 16 2 23 19 19 18 19 19 19 19 18 18 18 18 18 18 18 18 18 18 18 18 18 18 18 
19 19 18 18 19 18 18 18 19 18 19 18 19 18 19 18 19 18 19 19 18 24 16 2 2 2 2 2 2 16 23 19 18 18 19 19 19 19 19 18 19 19 19 19 19 19 18 18 24 16 2 8 3 7 2 2 2 2 2 2 2 2 2 2 2 16 23 18 24 33 16 33 2 2 2 16 16 23 18 18 18 19 19 18 19 18 18 18 18 18 18 18 18 18 18 18 18 18 18 18 
19 18 18 18 19 18 18 19 19 19 18 19 19 19 19 18 19 19 19 19 18 24 16 2 2 2 2 2 2 16 23 18 19 19 19 18 18 18 18 18 18 18 19 19 19 19 18 18 24 16 2 14 5 15 2 2 16 16 16 16 16 2 12 10 13 16 23 18 24 16 33 16 2 12 10 13 16 23 18 19 19 19 18 18 19 18 18 18 18 18 18 18 18 18 18 18 18 18 18 18 
18 18 18 18 19 19 19 19 19 19 18 19 19 19 19 19 19 19 19 19 18 24 16 2 2 2 2 2 2 16 23 18 18 18 19 19 19 19 19 19 18 18 19 18 19 19 19 18 24 16 2 2 2 16 2 2 16 16 2 2 16 2 8 3 7 16 23 18 30 21 21 22 16 8 3 7 16 23 18 19 19 19 19 18 19 18 18 18 18 18 18 18 18 18 18 18 18 18 18 18 
18 18 19 19 19 19 18 18 18 18 19 19 18 18 18 18 18 18 18 18 18 24 16 2 2 2 16 2 2 16 25 26 26 26 26 26 26 26 26 29 18 19 19 18 18 19 18 18 24 16 16 16 16 16 2 2 2 16 2 2 16 2 8 3 7 16 23 19 18 18 19 24 16 8 3 7 16 23 18 19 18 19 19 19 19 19 18 18 18 18 18 18 18 18 18 18 18 18 18 18 
18 18 19 18 18 19 19 19 19 19 18 19 18 19 18 18 18 19 19 18 18 24 16 2 2 16 16 2 2 16 16 16 16 16 16 16 16 16 16 23 18 19 19 18 18 19 18 18 24 2 16 16 2 2 2 2 16 2 2 16 2 2 8 3 7 16 23 18 18 18 19 24 16 8 3 7 16 23 18 18 18 19 18 19 19 19 19 18 18 18 18 18 18 18 18 18 18 18 18 18 
18 18 19 18 18 19 19 19 19 18 19 19 18 19 19 19 19 18 19 18 18 24 16 2 2 16 2 2 2 2 2 2 2 2 2 16 2 2 16 23 18 19 19 19 19 19 18 18 24 2 16 16 16 16 2 2 16 2 2 2 2 2 8 3 7 16 23 18 19 18 19 24 16 8 3 7 2 23 18 18 19 19 18 18 19 19 19 18 18 18 18 18 18 18 18 18 18 18 18 18 
18 18 18 19 19 19 18 19 19 19 19 18 18 18 19 19 18 18 19 19 28 27 16 2 2 16 16 2 2 2 2 2 2 2 2 2 16 2 16 23 18 19 18 18 19 19 19 18 24 2 2 2 2 16 2 2 16 16 16 16 16 16 8 3 7 2 25 26 26 26 26 27 16 8 3 7 16 23 18 19 19 18 18 18 19 19 18 18 18 18 18 18 18 18 18 18 18 18 18 18 
18 18 18 19 19 18 18 18 18 19 19 19 19 18 19 19 18 19 18 19 24 16 16 2 2 2 16 16 2 2 2 16 16 2 16 2 2 2 16 23 18 18 18 18 19 18 19 18 24 2 2 2 2 16 2 16 20 21 21 21 22 16 8 3 7 16 16 16 16 16 16 16 16 8 3 7 16 23 18 18 18 19 18 19 19 18 18 18 18 18 18 18 18 18 18 18 18 18 18 18 
18 18 18 18 19 19 19 19 18 18 18 18 18 18 19 19 18 18 18 18 24 16 2 2 2 2 16 16 2 2 2 2 16 16 16 16 2 2 16 23 18 18 18 18 18 19 19 18 24 2 16 16 16 16 2 2 23 18 18 18 24 16 8 3 9 10 10 10 10 10 10 10 10 11 3 7 2 23 18 18 19 18 18 18 19 18 18 18 18 18 18 18 18 18 18 18 18 18 18 18 
18 18 19 19 18 18 18 19 18 18 18 18 18 18 19 19 19 18 18 18 24 16 2 2 2 16 16 2 2 2 2 16 16 16 16 16 16 2 16 23 18 19 19 18 18 18 18 18 24 2 2 2 2 2 2 2 23 19 19 18 24 16 8 3 3 3 3 3 3 3 3 3 3 3 3 7 16 23 18 19 18 19 19 18 19 18 18 18 18 18 18 18 18 18 18 18 18 18 18 18 
18 18 19 18 19 19 18 19 18 19 19 19 19 19 19 18 19 19 18 18 24 16 16 2 2 16 16 16 16 16 16 16 16 16 16 16 16 16 16 23 18 19 18 19 18 18 18 18 30 21 21 21 21 21 21 21 31 18 18 18 24 2 14 5 5 5 5 5 5 5 5 5 5 5 5 15 2 23 18 19 18 19 19 19 19 19 19 18 18 18 18 18 18 18 18 18 18 18 18 18 
18 18 19 19 18 18 18 19 18 19 19 19 19 19 18 18 18 19 18 18 24 16 16 2 16 16 16 16 20 21 21 21 21 21 21 21 21 21 21 31 18 19 18 19 18 18 18 18 18 18 18 18 18 18 18 18 18 18 18 18 30 21 21 21 21 21 21 21 21 21 21 21 21 21 21 21 21 31 18 19 19 19 18 18 18 18 19 18 18 18 18 18 18 18 18 18 18 18 18 18 
18 18 18 18 18 18 19 18 18 18 18 19 19 19 18 18 18 19 19 18 30 21 21 21 21 21 21 21 31 18 18 18 18 18 18 18 18 18 18 18 18 19 18 19 18 18 18 18 19 18 18 19 19 19 19 19 18 18 18 18 18 18 18 18 18 18 18 18 19 19 18 18 18 18 18 18 18 18 18 18 19 19 18 18 18 19 19 18 18 18 18 18 18 18 18 18 18 18 18 18 
19 19 18 18 18 18 19 18 18 19 19 18 19 19 19 19 19 18 19 18 18 18 18 18 18 18 18 18 18 18 19 19 19 18 18 18 19 19 19 19 19 19 19 19 18 18 18 18 19 19 19 19 18 18 19 19 19 19 19 19 19 19 19 18 19 19 19 19 19 19 19 19 18 18 19 19 19 18 18 19 19 19 18 18 18 19 18 18 18 18 18 18 18 18 18 18 18 18 18 18 
19 19 18 19 19 19 19 19 19 18 19 19 19 18 19 19 19 19 19 18 18 19 19 19 19 19 18 18 18 19 19 18 19 19 19 19 18 18 18 19 19 19 19 18 18 18 18 18 19 19 18 18 19 19 19 18 19 18 18 18 19 19 19 19 19 18 18 19 19 19 19 19 19 19 19 18 19 19 19 19 18 19 19 19 19 19 18 18 18 18 18 18 18 18 18 18 18 18 18 18 
19 19 19 19 18 18 18 19 18 19 19 18 19 18 18 18 18 19 19 19 19 19 19 19 19 19 19 19 19 19 19 19 19 18 18 19 18 19 19 19 19 18 19 19 18 18 18 18 18 19 19 19 19 18 18 18 19 19 18 19 19 18 18 18 18 18 18 18 19 19 19 19 18 18 18 18 18 18 18 18 18 18 18 18 18 18 18 18 18 18 18 18 18 18 18 18 18 18 18 18 
19 19 19 18 18 18 18 19 19 19 18 18 18 19 18 18 18 19 19 19 19 18 18 18 18 18 18 18 18 18 18 18 18 18 18 19 19 19 18 18 19 19 19 19 18 18 18 18 18 18 18 18 18 18 18 18 18 18 18 18 18 18 18 18 18 18 18 18 18 18 18 18 18 18 18 18 18 18 18 18 18 18 18 18 18 18 18 18 18 18 18 18 18 18 18 18 18 18 18 18 
19 19 18 18 18 18 18 19 19 18 18 18 18 19 18 18 18 18 18 18 18 18 18 18 18 18 18 18 18 18 18 18 18 18 18 18 18 18 18 18 18 18 18 18 18 18 18 18 18 18 18 18 18 18 18 18 18 18 18 18 18 18 18 18 18 18 18 18 18 18 18 18 18 18 18 18 18 18 18 18 18 18 18 18 18 18 18 18 18 18 18 18 18 18 18 18 18 18 18 18 
18 18 19 18 18 18 18 19 19 19 19 19 19 19 18 18 18 18 18 18 18 18 18 18 18 18 18 18 18 18 18 18 18 18 18 18 18 18 18 18 18 18 18 18 18 18 18 18 18 18 18 18 18 18 18 18 18 18 18 18 18 18 18 18 18 18 18 18 18 18 18 18 18 18 18 18 18 18 18 18 18 18 18 18 18 18 18 18 18 18 18 18 18 18 18 18 18 18 18 18 
18 18 19 18 18 18 18 18 18 18 19 19 19 18 18 18 18 18 18 18 18 18 18 18 18 18 18 18 18 18 18 18 18 18 18 18 18 18 18 18 18 18 18 18 18 18 18 18 18 18 18 18 18 18 18 18 18 18 18 18 18 18 18 18 18 18 18 18 18 18 18 18 18 18 18 18 18 18 18 18 18 18 18 18 18 18 18 18 18 18 18 18 18 18 18 18 18 18 18 18 
18 18 19 18 18 18 18 18 19 19 18 18 18 18 18 18 18 18 18 18 18 18 18 18 18 18 18 18 18 18 18 18 18 18 18 18 18 18 18 18 18 18 18 18 18 18 18 18 18 18 18 18 18 18 18 18 18 18 18 18 18 18 18 18 18 18 18 18 18 18 18 18 18 18 18 18 18 18 18 18 18 18 18 18 18 18 18 18 18 18 18 18 18 18 18 18 18 18 18 18 
18 18 18 19 19 19 19 19 18 18 18 18 18 18 18 18 18 18 18 18 18 18 18 18 18 18 18 18 18 18 18 18 18 18 18 18 18 18 18 18 18 18 18 18 18 18 18 18 18 18 18 18 18 18 18 18 18 18 18 18 18 18 18 18 18 18 18 18 18 18 18 18 18 18 18 18 18 18 18 18 18 18 18 18 18 18 18 18 18 18 18 18 18 18 18 18 18 18 18 18 
